{
  "অ": "o",
  "আ": "a",
  "ই": "i",
  "ঈ":"I",
  "ঋ": "rri",
  "এ": "e",
  "ঐ": "oi",
  "ও": "o",
  "ঔ": "ou"
}